title	genre
The Enigmatic Drama	Drama
Lost in Time	Drama
Eternal Sunshine	Drama
Midnight Whispers	Drama
Innocence Lost	Drama
Crimson Echoes	Drama
Rising Stars	Drama
Echoes of Eternity	Drama
Broken Promises	Drama
Frozen in Time	Drama
Stolen Memories	Drama
Cursed Kingdom	Drama
Realm of Illusions	Drama
Mystic Whispers	Drama
Fading Memories	Drama
Edge of Eternity	Drama
Shadowed Past	Drama
Eternal Echoes	Drama
Unseen Horizons	Drama
Whispers of Hope	Drama
Forgotten Realms	Drama
Beneath the Surface	Drama
Lost Horizon	Drama
Requiem for a Dream	Drama
Soulbound	Drama
Mystic Shadows	Drama
Shattered Illusions	Drama
Whispers of Fate	Drama
Shattered Reflections	Drama
Legends of Winter	Drama
The Uncharted Journey	Action/Adventure
Quest for Glory	Action/Adventure
Secret of the Ancients	Action/Adventure
The Last Crusade	Action/Adventure
Guardians of Destiny	Action/Adventure
Echoes of Valor	Action/Adventure
Empire of Shadows	Action/Adventure
Odyssey of Legends	Action/Adventure
Clash of Titans	Action/Adventure
Rise of the Phoenix	Action/Adventure
The Adventurous Quest	Action/Adventure
Lost Treasures	Action/Adventure
Raiders of the Unknown	Action/Adventure
Realm of Legends	Action/Adventure
Beyond the Horizon	Action/Adventure
Epic Discovery	Action/Adventure
Legends Unleashed	Action/Adventure
Enchanted Expeditions	Action/Adventure
Visions of Valor	Action/Adventure
Journey to the Unknown	Action/Adventure
Quest for the Crystal	Action/Adventure
The Mysterious Expedition	Action/Adventure
Guardians of the Ancients	Action/Adventure
Chronicles of Courage	Action/Adventure
Legends Reborn	Action/Adventure
Chronicles of Destiny	Action/Adventure
Odyssey of Hope	Action/Adventure
The Hilarious Movie	Comedy
Laughing Waters	Comedy
Whimsical Whispers	Comedy
Fun Under the Sun	Comedy
Crazy Antics	Comedy
Laughter Therapy	Comedy
Giggles and Grins	Comedy
Hilarity Unleashed	Comedy
Rolling on the Floor	Comedy
Silly Adventures	Comedy
Endless Love	Romance
Love in the Air	Romance
Heartstrings	Romance
Enchanted Hearts	Romance
Love's Embrace	Romance
Sweet Serenade	Romance
Amour Forever	Romance
Unbreakable Bonds	Romance
Eternal Love	Romance
Romancing the Heart	Romance
Adventures of the Little Ones	Kids
Magic of Childhood	Kids
Enchanted Playtime	Kids
Quest for Imagination	Kids
Tales of Tiny Explorers	Kids
Wonderland Adventures	Kids
Joyful Journeys	Kids
Under the Rainbow	Kids
Galactic Odyssey	Sci-Fi
Stellar Explorers	Sci-Fi
Futuristic Frontiers	Sci-Fi
Beyond the Stars	Sci-Fi
Cosmic Adventures	Sci-Fi
Whispers in the Dark	Horror
Midnight Shadows	Horror
Dark Descent	Horror
Enchanted Darkness	Horror
Eerie Echoes	Horror
A Glimpse Through Time	Other
Beyond Boundaries	Other
Reflections of Reality	Other
Wanderlust	Other
In Search of Truth	Other